XXXXXXXXXXXXXXXXXXXXX
X                   X
XXXXXXXX            X
X      X            X
X   XXXXXX   XXXXXXXX
X                   X
XXXXXXXXXXXXXXXXXXXXX