XXXXXXXXXXXXXXXXXXXXX
X-X------------X----X
X-X-XXXXXXXXXX-X-X--X
X-X---OX-------X-X--X
X-XXXXXX-XXXXXXX-XXXX
X-X-----------------X
X-XXXXXXXXXX-XXXXXX-X
X-X--------X------XXX
X-XXXXXXXX-XXXXXX---X
X-X---XX-X-----XXXX-X
X-X-X----X-XXXX---X-X
X-X-X-XXXX------XXX-X
X-X-X-XXXXXXXXX-X---X
X-X-X-----------X-XXX
X---X-XXXXXXXXXXX-X-X
XXX-X-------------X-X
X-X-XXXXXXXXXXXXXXX-X
X-X-----------------X
X-XXXXXXXXXX--XXXXXXX
X-------------------X
XXXXXXXXXXXXXXXXXXXXX