XXXXXXXXXXXXXXXXXXXXX
X-------------------X
X-XXXXXXXXXXXX-XXXX-X
X------X----------X-X
XXXXXXXX-XXXXXXXXXX-X
X----------X--------X
X-X-XXXXXX-X-XXXXXXXX
X-X------X---X------X
X-X-XXXX-X-XXX-XXXX-X
X-X-X--X-------X----X
X-X-X-XXXXXXXX-X-XXXX
X-X-X----------X----X
X-XXXXXX-XXXXXXXXXX-X
X------X-X----------X
XXXXXXXXXX-XXXXXXXXXX
X--------------X----X
X-XXXXXX-XXXXX-X-XXOX
X-X----------X-X---XX
X-XXXXXXXXXXXXXXXX-XX
X------------------XX
XXXXXXXXXXXXXXXXXXXXX